Coincide: Trùng hợp
Commit: Cam kết
Conform: Tuân theo
Confront: Đối mặt
Confuse: Bối rối
Congratulate: Chúc mừng
Congress: Hội nghị
Consequence: Hậu quả
Consider: Xem sét
Deceive: Lừa dối, ngoại tình
Dialogue: Hộp thoại
Discrepancy: Khác nhau(đáng lẽ phải giống nhau)
Envelope: Bao thư
Especially: Đặc biệt riêng với
Hyphen: Gạch nối
Impress: Gây ấn tượng
Indicate: Chỉ ra
Legend: Huyền thoại
Moment: Khoảnh khắc
Recall: Gợi nhớ lại
Recommend: Khuyến cáo nên làm, giới thiệu
Refer: Giới thiệu, nhắm vào, nhắc tới
Refuse: Từ chối
Relevant: Có liên quan
Repel: Xua đuổi
Represent: Đại hiện
Signature: Chữ ký
Statement: Lời phát biểu, tuyên bố
Strain: Căng thẳng (vật lý)
Sympathy: Sự thông cảm