Almost: Hầu như
Confidence: Sự tự tin
Despite: Mặc dù
Emphasize: Nhấn mạnh
Express: Bày tỏ
Guess: Đoán là
Imply: Ám chỉ
Inform: Thống báo với ai đó
Initial: Ban đầu
Idiom: Ca dao, thành ngữ
Insist: Khăng khăng, nài nỉ
Issue: Vấn đề
Mention: Đề cập
Interrupt: Gián đoạn
Material: Nguyên liệu
Inquiry: Sự dò xét, thẩm vấn
Persuade: Thuyết phục, khuyên bảo
Predict: Dự đoán
Quote: Trích dẫn
Phase: Giao đoạn
Warn: Cảnh báo
Questionnaire: Bảng câu hỏi
Paragraph: Đoạn văn
Recent: Gầy đây
Respond: Phản hồi
Scream: Hét lên
Trick: Mẹo, kỹ thuật
Reflect: Bắt trước
Shout: Kêu la
Survey: Khảo sát
Tension: Căng thẳng, sức ép (về tinh thần)
Urge: thúc giục
Vowel: Nguyên âm